8 12
############
#P      C  #
###### #  ##
# C  C  C  #
######    ##
#   C    C #
# #  #  #  #
############