8 12
############
#P      C  #
###### #S ##
# C  C  C F#
######    ##
#   C    CM#
# #Z #  #  #
############