8 12
############
#P         #
###### #  ##
#          #
######    ##
#          #
# #  #  #  #
############