8 12
############
#P......C..#
######.#S.##
#.C..C..C.F#
######.M..##
#...C....C.#
#.#Z.#..#..#
############