8 12
############
#P      C  #
###### #G ##
# C  C  C G#
###### G  ##
# G C    C #
# #  #  #  #
############