5 15
###############
#P......C.@#..#
##.###.#S.##..#
#.C..C..C.F#..#
###############