12 16
################
#P......C..#...#
##.###.#S.##...#
#.C..C..C.F#...#
###.##.M.@##...#
#.&.C....C.#...#
#.#Z.#.8#.*#...#
#.C..C..C.F#...#
###.##.M.@##...#
#.&.C....C.#...#
#.#Z.#.8#.*#...#
################